12 28
-0,5 -0,5 -4
0 1 0
0 0 1
Tiles 3
1_11 1_11 1_11 1_11 1_11 1_11 1_11 1_11 1_11 1_11 1_11 1_11 1_11 1_11 1_11 1_11 1_11 1_11 1_11 1_11 1_11 1_11 1_11 1_11 1_11 1_11 1_11 1_11
1_11 1_11 1_11 1_11 1_11 1_11 1_11 1_11 1_11 1_11 1_11 1_11 1_11 1_11 1_11 1_11 1_11 1_11 1_11 1_11 1_11 1_11 1_11 1_11 1_11 1_11 1_11 1_11
1_11 1_11 1_11 1_11 1_11 1_11 1_11 1_11 1_11 1_11 1_11 1_11 1_11 1_11 1_11 1_11 1_11 1_11 1_11 1_11 1_11 1_11 1_11 1_11 1_11 1_11 1_11 1_11
1_11 1_11 1_11 1_11 1_11 1_11 1_11 1_11 1_11 1_11 1_11 1_11 1_11 1_11 1_11 1_11 1_11 1_11 1_11 1_11 1_11 1_11 1_11 1_11 1_11 1_11 1_11 1_11
1_11 1_11 1_11 1_11 1_11 1_11 1_11 1_11 1_11 1_11 1_11 1_11 1_11 1_11 1_11 1_11 1_11 1_11 1_11 1_11 1_11 1_11 1_11 1_11 1_11 1_11 1_11 1_11
1_11 1_11 Null Null Null Null Null Null Null 1_11 1_11 1_11 1_11 Null Null Null Null Null Null Null 1_11 1_11 1_11 1_11 1_11 1_11 1_11 1_11
1_11 1_11 Null Null Null Null Null Null Null 1_11 1_11 1_11 1_11 Null Null Null Null Null Null Null 1_11 1_11 1_11 1_11 1_11 1_11 1_11 1_11
1_11 1_11 Null Null Null Null Null Null Null 1_11 1_11 1_11 1_11 Null Null Null Null Null Null Null 1_11 1_11 1_11 1_11 1_11 1_11 1_11 1_11
1_11 1_11 Null Null Null Null Null Null Null 1_11 1_11 1_11 1_11 Null Null Null Null Null Null Null 1_11 1_11 1_11 1_11 1_11 1_11 1_11 1_11
1_11 1_11 Null Null Null Null Null Null Null 1_11 1_11 1_11 1_11 Null Null Null Null Null Null Null 1_11 1_11 1_11 1_11 1_11 1_11 1_11 1_11
1_11 1_11 Null Null Null Null Null Null Null 1_11 1_11 1_11 1_11 Null Null Null Null Null Null Null 1_11 1_11 1_11 1_11 1_11 1_11 1_11 1_11
1_11 1_11 1_11 1_11 1_11 1_11 1_11 1_11 1_11 1_11 1_11 1_11 1_11 1_11 1_11 1_11 1_11 1_11 1_11 1_11 1_11 1_11 1_11 1_11 1_11 1_11 1_11 1_11